2021  6 18   1 5 2 4 4
2021  6 19   4 0 2 4 4
2021  6 20   5 5 1 3 1
2021  6 21   1 1 2 3 1
2021  6 22   1 0 2 3 2
2021  6 23   2 3 0 2 0
2021  6 24   7 0 3 0 4
2021  6 25   2 5 3 1 4
2021  6 26   3 3 2 3 3
2021  6 27   4 3 3 5 3
2021  6 28   7 2 2 3 2
2021  6 29   9 5 1 1 3
2021  6 30   6 5 2 0 3
2021  7  1   6 4 2 4 3
2021  7  2   6 3 2 3 0
2021  7  3   0 0 1 3 3
2021  7  4   9 5 0 4 1
2021  7  5   0 4 0 5 3
2021  7  6   4 3 2 1 2
2021  7  7   8 2 2 3 1
2021  7  8   3 5 3 0 4
2021  7  9   0 3 2 5 1
2021  7 10   1 5 0 4 0
2021  7 11   9 5 1 3 2
2021  7 12   6 0 1 0 0
2021  7 13   7 3 2 5 2
2021  7 14   0 4 1 4 1
2021  7 15   0 3 3 1 2
2021  7 16   7 5 1 3 0
2021  7 17   9 1 2 5 3
2021  7 18   2 4 2 4 3
2021  7 19   8 0 3 0 0
2021  7 20   0 5 0 5 3
2021  7 21   3 1 1 2 0
2021  7 22   1 2 2 4 1
2021  7 23   1 0 3 0 4
2021  7 24   1 0 1 1 3
2021  7 25   8 0 0 1 2
2021  7 26   8 1 0 1 2
2021  7 27   1 0 1 1 4
2021  7 28   9 2 3 3 0
2021  7 29   9 1 0 4 3
2021  7 30   4 4 0 5 4
2021  7 31   2 3 1 3 3
2021  8  1   3 3 2 5 3
2021  8  2   0 0 2 0 1
2021  8  3   8 5 1 2 4
2021  8  4   7 0 2 4 2
2021  8  5   8 5 2 5 3
2021  8  6   1 3 0 4 1
2021  8  7   2 0 0 3 3
2021  8  8   6 4 2 5 3
2021  8  9   9 0 0 0 1
2021  8 10   8 2 3 1 4
2021  8 11   7 0 0 5 0
2021  8 12   2 2 2 3 4
2021  8 13   1 0 1 3 0
2021  8 14   3 4 1 2 0
2021  8 15   8 4 1 3 2
2021  8 16   2 5 2 5 4
2021  8 17   6 3 0 0 0
2021  8 18   5 2 1 1 2
2021  8 19   5 0 2 3 4
2021  8 20   3 1 0 1 4
2021  8 21   9 1 2 1 3
2021  8 22   5 3 0 2 0
2021  8 23   8 4 3 0 4
2021  8 24   1 2 3 2 3
2021  8 25   3 1 1 1 2
2021  8 26   8 2 1 5 1
2021  8 27   1 4 2 4 1
2021  8 28   4 0 2 1 1
2021  8 29   5 2 1 2 4
2021  8 30   9 0 3 3 4
2021  8 31   4 2 1 3 1
2021  9  1   3 4 2 2 3
2021  9  2   7 5 2 5 2
2021  9  3   5 5 2 2 4
2021  9  4   4 2 0 5 3
2021  9  5   0 5 1 0 2
2021  9  6   3 2 3 4 2
2021  9  7   5 0 0 5 2
2021  9  8   2 1 3 3 3
2021  9  9   4 1 0 5 1
2021  9 10   3 0 1 5 0
2021  9 11   1 2 2 2 1
2021  9 12   4 4 3 2 3
2021  9 13   4 2 2 1 3
2021  9 14   1 2 0 5 0
2021  9 15   0 2 2 1 4
2021  9 16   9 1 0 4 3
2021  9 17   2 1 2 4 3
2021  9 18   1 2 2 0 4
2021  9 19   2 4 3 4 1
2021  9 20   0 5 2 5 1
2021  9 21   7 1 2 0 4
2021  9 22   2 4 1 1 2
2021  9 23   4 3 3 1 3
2021  9 24   3 2 2 4 3
2021  9 25   6 5 1 1 0
2021  9 26   4 4 2 4 0
2021  9 27   6 1 3 3 2
2021  9 28   3 4 2 2 3
2021  9 29   3 2 3 2 4
2021  9 30   0 1 2 4 0
2021 10  1   7 5 0 0 4
2021 10  2   3 4 1 2 2
2021 10  3   8 5 3 1 0
2021 10  4   0 0 1 0 0
2021 10  5   0 1 0 1 1
2021 10  6   2 4 3 1 1
2021 10  7   6 0 1 0 2
2021 10  8   7 3 1 3 1
2021 10  9   2 1 0 3 1
2021 10 10   5 5 3 3 4
2021 10 11   5 1 0 0 0
2021 10 12   3 0 0 4 4
2021 10 13   2 1 1 2 3
2021 10 14   7 5 3 1 2
2021 10 15   8 1 2 3 2
2021 10 16   4 1 1 3 4
2021 10 17   5 5 2 0 4
2021 10 18   5 1 2 4 4
2021 10 19   1 1 2 5 4
2021 10 20   6 1 0 1 2
2021 10 21   8 5 0 1 1
2021 10 22   5 3 2 2 1
2021 10 23   7 0 2 0 3
2021 10 24   6 1 0 1 0
2021 10 25   2 2 2 3 2
2021 10 26   2 5 1 5 0
2021 10 27   8 5 2 3 4
2021 10 28   0 1 1 0 1
2021 10 29   0 0 2 5 4
2021 10 30   2 3 0 1 3
2021 10 31   9 3 0 0 2
2021 11  1   9 0 1 1 2
2021 11  2   1 5 0 3 4
2021 11  3   1 5 3 1 3
2021 11  4   2 0 1 4 4
2021 11  5   0 4 3 4 0
2021 11  6   6 0 2 5 2
2021 11  7   4 5 1 1 1
2021 11  8   3 4 3 3 0
2021 11  9   4 0 3 3 1
2021 11 10   4 0 0 0 0
2021 11 11   5 3 3 4 3
2021 11 12   7 0 0 1 4
2021 11 13   3 5 1 2 1
2021 11 14   8 5 2 5 0
2021 11 15   9 2 1 0 0
2021 11 16   8 4 2 1 3
2021 11 17   2 4 0 1 0
2021 11 18   3 3 3 5 2
2021 11 19   0 5 3 3 3
2021 11 20   3 3 0 3 2
2021 11 21   9 3 1 1 3
2021 11 22   2 2 0 5 3
2021 11 23   4 2 2 0 4
2021 11 24   3 4 0 4 2
2021 11 25   6 5 3 0 0
2021 11 26   8 1 1 4 3
2021 11 27   3 5 1 4 4
2021 11 28   5 2 2 1 0
2021 11 29   5 5 1 4 4
2021 11 30   5 0 2 5 3
